=== 自动建图可视化 ===
说明: . = 空闲空间, # = 障碍物, R = 机器人路径
建图方式: 自动探索算法（改进版）

地图范围: X[-2.0, 26.9], Y[-2.0, 2.0]
网格尺寸: 60x60

............................................................
............................................................
............................................................
............................................................
............................................................
............................................................
............................................................
............................................................
..................#.........................................
..................#.........................................
..............#.##............................#.............
................#.............................#.............
..............##..............................#.............
...............#..............................##............
..............#................................#....#.......
................#............#.................##...........
..............#.#...............................#..###......
..............................#.................#...###.....
..............#.#.............#.....#...........##.##.......
.....#........#.#............##..................##.#.......
...............##...................#............####.......
..............##....................#.............###.......
..............#...........................#..#....##........
....##........##..........................#..#...###..##....
...............#.........................##.##...###..#.....
..............##.........................###.#...######.....
...........#..##.........................#.#.##..####.......
...........#..##...........................#######.##.......
...........#####..##............................###.#.......
....RRRRRRRRRRRRRRRRR#RRRRRRRRRRRRRRRRRRRRRRRRRRRRRRRRR.....
... (省略其余行，完整地图见PPM图片文件)

地图统计:
机器人路径点: 50
障碍物点: 232
自由空间点: 3318
自动探索共访问了 2492 个位置
